00000000000000000000
00000000000000000000
00000000000000000000
00001111111110000000
00001000000010000000
00001000000010000000
00001000000011000000
00001010000001000000
00000110000001100000
00000010000000110000
00000110000000011000
00000110000000001000
00000011100000001000
00000000100000000000
00000000100000000000
00000000100000000000
00000000100000000000
00000000100000000000
00000000000000000000
00000000000000000000
